a'space => aerospace
advent => adventist
aft => after
amk => ang mo kio
apt => apartments
architect => architecture
ave => avenue
bef => before
bet => between
biz => business
bldg => building
blk => block
blks => blocks
blvd => boulevard
br => branch
bt => bukit
c'wealth => commonwealth
cath => cathedral
cc => community centre
cck => choa chu kang
center => centre
ch => church
checkpt => checkpoint
chr => christian
cl => close
co => company
comm => commission
comm => community
corp => corporation
cp, car park => carpark
cplx => complex
cres => crescent
ct => court
ctr => centre
ctrl => central
div => division
dp => distripark
dr => drive
engrg => engineering
env => environment
est => estate
fac => faculty
fc => food centre
fty => factory
gdn => garden
gdns => gardens
gov, govt => government
gr => grove
hme => home
hosp => hospital
hq => headquarters
hse => house
hts => heights
ind => industrial
insp => inspection
inst => institute
int => interchange
intl => international
jc => junior college
jln => jalan
lib => library
lor => lorong
lp, lamp post, street lamp => lamppost
lt => lecture theatre
ltd => limited
mans => mansion
mbs => marina bay sands
med => medical
meth => methodist
mfg => manufacturing
min => ministry
mkt => market
mohd, muhd
mque => mosque
mt => mount
natl => national
no => number
nth => north
nuh => national university hospital
opp => opposite
pk => park
pl => place
po => post office
poly => polytechnic
pr => primary
prep => preparatory
proc => processing
pt => point
pte => private
rd => road
s => shibuya
s'goon => serangoon
sch => school
sci => science
sec => secondary
sgh => singapore general hospital
shop => shopping
sma => singapore maritime academy
sp, s'pore => singapore
sq => square
st => street
st. => saint
sth => south
stn => station
sub-stn => substation
svc => service
svcs => services
swim => swimming
tech => technology
temp => temporary
ter, terr => terrace
tg => tanjong
tp => temple
trg => training
trspt => transport
twr => tower
twrs => towers
upp => upper
veh => vehicle
warehse => warehouse
wk => walk
